
################
#.###.#..#..##T#
#.....#..#.....#
#.##.........#.#
......#..#.#...#
..##..#..#..#..#
#O#.......#.#..#
#.#####.###.#..#
#@....#........#
################