00000000000000000
00000111000000000
00000211000000000
00000112000000000
00011212100000000
00010100100000000
01110100100000110
01211211111111114
00000100010300110
00000111110000000
00000000000000000