00000000000000
00000000000011
00000000000011
01111011212114
01222021121011
01121111121011
01221021212000
01121011111000
00100000000000
01111011110000
01111121110000
01122022113000
01111011110000
00000000000000