################
#.###.#..#..##E#
#.....#..#.....#
#.###....#...###
#.....#..#.#...#
#.#####..#..#..#
#.#.......#.#..#
#.#####.###.#..#
#@....#........#
################