########
#@     #
###### #
#      #
# ######
#    %&#
########