########
#@     #
#      #
#      #
#      #
#    %&#
########